###0##############
#................#
#................#
#................#
#................#
#................#
###########1######