# # # # # # 0 # # 
# . . . . . . . #
# . # # . # # . # 
# . # . . . # . #
# . # . # . # . #
# . # . # . # . #
# . # . # . # # #
# . . . . . . . #
# # # # # # # 1 #