# # # 0 # # # # # # # # # # # # # # # #
# . . . . # . . . . # . . . . . . . . #
# . . . . # . # . . # . # # # # # . . #
# . . . . # . # . . # . . . . . . . . #
# . . . . . . # . . . . . . # # # # . #
# . . . . # . # . . # . . . . . . . . #
# # # # # # # # # # # # # 1 # # # # # #
