# # # # # # # # # #
0 . . . . # . . . #
# # # # . # . . . #
# . . . . # . . . #
# . . . . # . # . #
# . . . . . . # . #
# . . . . . . # . #
# # # # # # # # 1 #