# # # 0 # # # # # # # # # # # # # # # # # # #
# . . . . # . . . . # . . . . . . . . . . . #
# . . . . # . # . . # . . # . . . . . . . . #
# . . . . # . # . . # . . # . . . . . . . . #
# . . . . . . # . . . . . # # # . # # # # . #
# . . . . # . # . . # . . # . # . . . . . . #
# # # # # # # # # # # # # # # # 1 # # # # # #

